........................................
........................................
........................................
........................................
........................................
........................###.............
........................................
..................#.....................
..@...../#\.......#.....................
########################################
########################################
########################################
########################################